20
13
0 3
2 17
7 6
17 1
17 18
12 12
18 9
5 14
14 6
9 18
11 3
7 2
2 8
0 0 0 2 0 0 0 0 0 0 0 0 0 0 0 0 0 0 0 0 
0 0 0 0 0 0 0 0 0 0 0 0 0 0 0 0 0 0 0 0 
0 0 0 1 1 0 0 0 2 0 0 0 0 1 1 1 1 2 0 0 
0 0 0 1 1 0 0 0 0 0 0 0 0 1 1 1 1 0 0 0 
0 0 0 1 1 0 0 0 0 0 0 0 0 0 0 1 1 0 0 0 
0 0 0 1 1 0 0 0 0 0 0 0 0 0 2 1 1 0 0 0 
0 0 0 1 1 0 0 0 0 0 0 0 0 0 0 1 1 0 0 0 
0 0 2 1 1 0 2 0 0 1 1 0 0 0 0 1 1 0 0 0 
0 0 0 0 0 0 0 0 0 1 1 0 0 0 0 1 1 0 0 0 
0 0 0 0 0 0 0 0 0 1 1 0 0 0 0 1 1 0 2 0 
0 0 0 0 0 0 0 0 0 1 1 0 0 0 0 1 1 1 1 0 
0 0 0 2 0 0 0 0 0 1 1 0 0 0 0 1 1 1 1 0 
0 0 0 1 1 1 1 1 1 1 1 0 2 0 0 0 0 0 0 0 
0 0 0 1 1 1 1 1 1 1 1 0 0 0 0 0 0 0 0 0 
0 0 0 0 0 0 2 1 1 1 1 0 0 0 0 0 0 0 0 0 
0 0 0 0 0 0 0 1 1 1 1 1 1 1 0 0 0 0 0 0 
0 0 0 0 0 0 0 1 1 1 1 1 1 1 0 0 0 0 0 0 
0 2 0 0 0 0 0 1 1 0 0 0 0 0 0 0 0 0 2 0 
0 0 0 0 0 0 0 1 1 2 0 0 0 0 0 0 0 0 0 0 
0 0 0 0 0 0 0 1 1 0 0 0 0 0 0 0 0 0 0 0  