20
5
0 3
2 17
7 6
17 1
17 18
0 0 0 2 0 0 0 0 0 0 0 0 0 0 0 0 0 0 0 0 
0 0 0 0 0 0 0 0 0 0 0 0 0 0 0 0 0 0 0 0 
0 0 0 1 1 0 0 0 0 0 0 0 0 1 1 1 1 2 0 0 
0 0 0 1 1 0 0 0 0 0 0 0 0 1 1 1 1 0 0 0 
0 0 0 1 1 0 0 0 0 0 0 0 0 0 0 1 1 0 0 0 
0 0 0 1 1 0 0 0 0 0 0 0 0 0 0 1 1 0 0 0 
0 0 0 1 1 0 0 0 0 0 0 0 0 0 0 1 1 0 0 0 
0 0 0 1 1 0 2 0 0 1 1 0 0 0 0 1 1 0 0 0 
0 0 0 0 0 0 0 0 0 1 1 0 0 0 0 1 1 0 0 0 
0 0 0 0 0 0 0 0 0 1 1 0 0 0 0 1 1 0 0 0 
0 0 0 0 0 0 0 0 0 1 1 0 0 0 0 1 1 1 1 0 
0 0 0 0 0 0 0 0 0 1 1 0 0 0 0 1 1 1 1 0 
0 0 0 1 1 1 1 1 1 1 1 0 0 0 0 0 0 0 0 0 
0 0 0 1 1 1 1 1 1 1 1 0 0 0 0 0 0 0 0 0 
0 0 0 0 0 0 0 1 1 1 1 0 0 0 0 0 0 0 0 0 
0 0 0 0 0 0 0 1 1 1 1 1 1 1 0 0 0 0 0 0 
0 0 0 0 0 0 0 1 1 1 1 1 1 1 0 0 0 0 0 0 
0 2 0 0 0 0 0 1 1 0 0 0 0 0 0 0 0 0 2 0 
0 0 0 0 0 0 0 1 1 0 0 0 0 0 0 0 0 0 0 0 
0 0 0 0 0 0 0 1 1 0 0 0 0 0 0 0 0 0 0 0  