20
6
1 1
1 9
9 9
9 17
17 1
17 9
0 0 0 0 0 0 0 0 0 0 0 0 0 0 0 0 0 0 0 0 
0 2 0 0 0 0 0 0 1 2 0 0 0 1 1 1 0 0 0 0 
0 0 1 1 1 0 0 0 1 0 0 0 0 1 0 0 0 0 0 0 
0 0 0 0 1 0 0 0 1 0 0 0 0 1 1 1 1 1 0 0 
1 1 0 0 1 1 1 1 1 0 0 0 0 0 0 0 0 0 0 0 
0 0 0 0 1 0 0 0 0 0 0 0 0 0 0 0 0 0 0 0 
0 0 1 1 1 0 0 0 0 0 0 0 0 0 0 1 1 1 1 0 
0 0 0 0 0 0 0 0 1 1 1 1 0 0 0 0 0 1 1 1 
1 1 1 0 0 0 0 0 1 1 1 1 0 0 0 0 0 0 0 1 
0 0 1 1 0 0 0 0 0 2 1 1 0 0 0 1 0 2 0 1 
0 0 0 1 1 0 0 0 0 0 1 1 1 0 0 1 1 1 1 1 
1 0 0 0 1 1 0 0 0 0 0 1 1 1 0 0 0 0 1 1 
1 1 0 0 0 0 0 0 0 0 0 0 1 1 1 0 0 0 1 1 
0 1 1 0 0 0 0 0 0 0 0 0 0 1 1 1 0 0 0 0 
0 0 1 1 0 0 0 0 0 0 0 0 0 0 0 0 0 0 0 0 
0 0 0 0 0 0 0 0 0 0 0 0 0 0 1 1 1 0 0 0 
1 0 0 0 0 0 0 0 1 1 1 0 0 0 1 1 1 0 0 0 
1 2 1 0 0 0 0 1 1 2 1 1 0 0 1 1 1 0 0 0 
1 1 1 0 0 0 0 0 0 0 0 0 0 0 0 0 0 0 0 0 
0 0 0 0 0 0 0 0 0 0 0 0 0 0 0 0 0 0 0 0  