15
20
4 10
5 1
8 12
13 1
0 1
14 13
1 13
6 7
2 6 
12 7
8 6
8 8
13 11
9 3
13 9
1 4
0 8
5 13
14 4
11 14
0 2 0 0 0 0 0 0 2 0 0 0 0 0 0 
0 0 0 0 2 0 0 0 0 0 0 0 0 2 0 
0 0 0 1 1 1 1 2 0 0 0 0 0 0 0 
0 0 0 0 0 0 1 1 1 1 1 0 0 0 0 
0 0 0 0 0 0 1 0 0 0 2 0 0 0 0 
0 2 0 0 0 0 0 0 0 0 0 0 0 2 0 
0 0 0 0 0 0 0 2 0 0 1 1 1 1 1 
0 0 0 0 0 0 0 1 0 0 0 0 0 0 0 
1 1 1 1 1 0 2 1 2 0 0 0 2 0 0 
0 0 0 2 0 0 0 1 0 0 0 0 0 0 0 
0 0 0 0 0 0 0 1 0 0 0 0 0 0 0 
0 0 0 0 1 1 1 1 0 0 1 1 1 0 2 
0 0 0 0 0 0 0 2 0 0 1 0 0 0 0 
0 2 0 0 0 0 0 0 0 2 1 2 0 0 0 
0 0 0 0 2 0 0 0 0 0 1 0 0 2 0  