20
5
4 6
4 13
11 3
11 16
16 9
0 0 0 0 0 0 0 0 0 0 0 0 0 0 0 0 0 0 0 0 
0 0 0 0 0 0 0 0 0 0 1 0 0 0 0 0 0 0 0 0 
0 0 0 1 0 0 0 0 0 1 1 1 1 0 0 0 1 0 0 0 
0 0 1 1 1 0 0 0 1 1 1 1 0 0 0 1 1 1 0 0 
0 0 1 1 1 0 2 0 0 1 0 0 0 2 0 1 1 1 0 0 
0 0 1 1 1 0 0 0 0 1 0 0 0 0 0 1 1 1 0 0 
0 1 1 1 1 1 0 0 0 1 0 0 0 0 1 1 1 1 1 0 
0 0 1 1 1 0 0 0 1 1 1 0 0 0 0 1 1 1 0 0 
0 0 0 1 0 0 0 1 1 1 1 1 0 0 0 0 1 0 0 0 
0 0 0 1 0 0 1 1 1 1 1 1 1 0 0 1 1 1 0 0 
0 0 1 1 1 0 0 1 1 1 1 1 0 0 1 1 1 1 1 0 
0 0 0 2 0 1 0 0 1 1 1 0 0 1 0 0 2 0 0 0 
1 1 0 0 0 1 0 0 0 1 0 0 0 1 0 0 0 0 0 1 
1 1 0 0 1 1 1 0 0 0 0 0 1 1 1 0 0 1 1 1 
1 0 0 1 1 1 1 1 0 0 1 1 1 1 1 1 0 0 1 1 
0 0 0 1 1 1 1 0 0 0 0 1 1 1 1 1 0 0 0 1 
0 0 1 1 1 1 0 0 0 2 0 0 1 1 1 1 1 0 0 1 
0 1 1 1 1 0 0 0 0 0 0 0 0 1 1 1 0 0 0 0 
0 0 1 1 0 0 0 0 0 0 0 0 0 0 1 0 0 0 0 0 
0 0 0 0 0 0 0 0 0 0 0 0 0 0 0 0 0 0 0 0 
