20
4
0 3
2 17
15 4
17 18
0 0 0 2 0 0 0 0 0 0 0 0 0 0 0 0 0 0 0 0 
0 0 0 0 0 0 0 0 0 0 0 0 0 0 0 0 0 0 0 0 
0 0 1 1 1 0 0 0 1 1 1 0 0 0 0 1 1 2 0 0 
0 0 1 1 1 0 0 0 1 1 1 0 0 0 0 1 1 1 0 0 
0 0 1 1 1 0 0 0 1 1 1 0 0 0 0 1 1 1 0 0 
0 0 1 1 1 0 0 0 1 1 1 0 0 0 0 1 1 1 0 0 
0 0 1 1 1 0 0 0 1 1 1 0 0 0 0 1 1 1 0 0 
0 0 1 1 1 0 0 0 1 1 1 0 0 0 0 1 1 1 0 0 
0 0 1 1 1 0 0 0 1 1 1 0 0 0 0 1 1 1 0 0 
0 0 1 1 1 0 0 0 1 1 1 0 0 0 0 1 1 1 0 0 
0 0 1 1 1 0 0 0 1 1 1 0 0 0 0 1 1 1 0 0 
0 0 1 1 1 0 0 0 1 1 1 0 0 0 0 1 1 1 0 0 
0 0 1 1 1 0 0 0 1 1 1 0 0 0 0 1 1 1 0 0 
0 0 1 1 1 0 0 0 1 1 1 0 0 0 0 1 1 1 0 0 
0 0 0 1 2 0 1 1 1 1 1 1 1 1 1 1 1 0 0 0 
0 0 0 0 1 1 1 1 1 0 1 1 1 1 1 1 0 0 0 0 
0 0 0 0 0 1 1 0 0 0 0 0 0 1 1 0 0 0 2 0 
0 0 0 0 0 0 1 0 0 0 0 0 0 1 0 0 0 0 0 0 
0 0 0 0 0 0 0 0 0 0 0 0 0 0 0 0 0 0 0 0 
0 0 0 0 0 0 0 0 0 0 0 0 0 0 0 0 0 0 0 0  